rooms,xCoords,yCoords,numMonsters,deadlyScore
 -1,0,0,0,0
0,0,0,0,0
1,0,-1,8,0
2,0,-2,0,0
3,0,1,2,0
4,1,1,7,0
5,1,2,1,0
6,-1,1,0,0
7,-1,2,0,0
8,0,2,0,0
9,-2,2,1,0
10,-2,3,5,0
11,-3,3,3,0
12,-4,3,3,0
13,-4,4,8,0
14,-5,4,3,0
15,-3,2,5,0
16,-3,1,6,0
17,-2,1,3,0
18,-3,0,5,0
19,-4,1,5,0
20,-3,4,5,0
21,-3,5,8,0
22,-2,5,0,0
23,-4,5,0,0
24,-3,6,0,0
25,-1,3,0,0
26,-1,4,0,0
27,-1,5,0,0
28,-1,6,0,0
29,-1,7,0,0
30,-1,8,0,0
