rooms,xCoords,yCoords,numMonsters,miniBoss
 -1,0,0,0,0
0,0,0,0,0
1,0,1,2,0
2,1,1,2,0
3,2,1,7,0
4,2,0,6,0
5,1,0,0,0
6,3,0,0,0
7,2,-1,0,0
8,3,1,0,1
9,3,-1,0,0
10,3,-2,0,0
11,3,-3,0,0
12,4,-3,0,0
13,3,-4,0,0
14,2,-3,4,0
15,4,-4,5,0
16,4,-5,5,0
17,3,-5,0,0
18,5,-5,0,0
19,4,-6,0,0
20,4,-2,0,1
21,3,-6,0,0
22,3,-7,8,0
23,4,-7,0,0
24,4,-1,6,0
25,4,0,0,0
26,2,-6,1,0
27,1,-6,0,0
28,5,-7,0,0
29,5,-6,0,1
30,6,-7,0,0
31,7,-7,0,0
32,7,-6,0,0
