rooms,xCoords,yCoords,numMonsters,miniBoss
 -1,0,0,0,0
0,0,0,0,0
1,-1,0,4,0
2,-1,1,4,0
3,-2,1,4,0
4,-1,2,5,0
5,0,1,3,0
6,1,1,6,0
7,2,1,6,0
8,2,0,0,0
9,2,2,0,0
10,3,1,0,0
11,3,0,0,1
12,-1,3,1,0
13,0,3,0,0
14,0,4,8,0
15,1,3,0,0
16,0,2,0,0
17,-2,3,8,0
18,-3,3,0,0
19,2,3,0,1
20,2,4,0,0
21,0,5,1,0
22,-1,5,2,0
23,3,3,3,0
24,4,3,0,0
25,3,4,7,0
26,3,5,8,0
27,4,5,0,0
28,2,5,0,0
29,3,6,0,0
30,0,6,0,0
31,-1,6,0,0
32,3,2,0,0
33,4,2,0,1
34,4,1,0,0
35,5,2,0,0
36,5,1,0,0
37,6,1,0,0
38,7,1,0,0
