rooms,xCoords,yCoords,numMonsters,miniBoss
 -1,0,0,0,0
0,0,0,0,0
1,-1,0,0,0
2,-2,0,0,0
3,-2,-1,1,0
4,-3,0,0,0
5,-2,1,2,0
6,-2,-2,5,0
7,-1,-2,7,0
8,-1,-3,0,0
9,-1,-1,0,0
10,0,-2,0,0
11,1,0,0,1
12,1,-1,0,0
13,-2,2,3,0
14,-2,3,7,0
15,-3,3,1,0
16,-3,4,4,0
17,-4,3,0,0
18,-5,3,6,0
19,-5,2,1,0
20,-4,2,0,0
21,-4,1,0,1
22,-5,1,0,0
23,-6,1,0,0
24,-6,2,0,0
25,-7,2,0,0
