rooms,xCoords,yCoords,numMonsters,miniBoss
 -1,0,0,0,0
0,0,0,0,0
1,0,1,1,0
2,-1,1,0,0
3,-1,0,4,0
4,-2,1,6,0
5,-1,2,5,0
6,1,1,7,0
7,1,2,7,0
8,2,2,0,0
9,0,2,0,0
10,1,3,0,0
11,0,3,0,1
12,0,4,0,0
13,2,3,0,0
14,3,3,3,0
15,4,3,5,0
16,4,4,7,0
17,5,4,0,0
18,3,4,0,0
19,4,5,0,0
20,5,3,0,1
21,4,2,0,0
22,5,2,0,0
23,6,2,0,0
24,7,2,7,0
25,7,3,7,0
26,8,3,0,0
27,6,3,0,0
28,7,4,0,0
29,7,1,0,0
30,6,1,3,0
31,9,3,0,0
32,9,4,0,1
33,9,5,0,0
34,9,2,0,0
35,10,2,0,0
36,11,2,0,0
