rooms,xCoords,yCoords,numMonsters,miniBoss
 -1,0,0,0,0
0,0,0,0,0
1,1,0,7,0
2,2,0,5,0
3,2,-1,0,0
4,2,1,0,0
5,3,0,0,0
6,2,-2,0,0
7,3,-2,8,0
8,3,-1,2,0
9,2,2,0,0
10,2,3,0,1
11,2,4,5,0
12,2,5,5,0
13,3,5,0,0
14,1,5,0,0
15,2,6,0,0
16,1,2,3,0
17,1,3,0,0
18,3,6,0,0
19,4,6,0,1
20,3,7,2,0
21,4,7,1,0
22,4,5,0,0
23,4,4,0,0
24,4,3,0,0
