rooms,xCoords,yCoords,numMonsters,miniBoss
 -1,0,0,0,0
0,0,0,0,0
1,0,-1,0,0
2,0,-2,2,0
3,-1,0,6,0
4,-1,1,0,1
5,-1,2,0,0
6,0,2,3,0
7,0,1,5,0
8,1,1,3,0
9,-2,2,2,0
10,-3,2,8,0
11,-3,1,3,0
12,-2,1,4,0
13,-2,0,0,0
14,-2,3,0,1
15,-2,4,0,0
16,-3,3,0,0
17,-3,4,0,0
18,-4,4,2,0
19,-5,4,6,0
20,-5,3,1,0
21,-6,4,5,0
22,-5,5,0,0
23,-3,5,7,0
24,-3,6,0,1
25,-4,3,1,0
26,-4,2,2,0
27,-3,7,4,0
28,-4,6,2,0
29,-4,7,8,0
30,-5,7,1,0
31,-2,7,0,0
32,-1,7,0,1
33,-1,8,0,0
34,-2,6,0,0
35,-2,5,0,0
36,-1,5,0,0
