rooms,xCoords,yCoords,numMonsters,deadlyScore
 -1,0,0,0,0
0,0,0,0,0
1,-1,0,2,0
2,-2,0,8,0
3,-2,-1,1,0
4,-3,-1,5,0
5,-1,-1,0,0
6,-1,-2,3,0
7,-1,1,0,0
8,-1,2,0,0
9,-1,3,0,0
10,-2,2,0,0
11,-2,1,7,0
12,-3,1,0,0
13,-3,2,0,0
14,-4,2,0,0
15,-2,3,0,0
16,-2,4,0,0
17,-2,5,2,0
18,-3,5,4,0
19,-3,4,1,0
20,-2,6,0,0
21,-3,6,0,0
22,-4,6,0,0
