rooms,xCoords,yCoords,numMonsters,deadlyScore
 -1,0,0,0,0
0,0,0,0,0
1,0,-1,2,0
2,-1,-1,5,0
3,-1,-2,3,0
4,0,-2,3,0
5,1,-2,2,0
6,-2,-2,0,0
7,-2,-3,4,0
8,-1,-3,0,0
9,-2,-4,3,0
10,-3,-3,0,0
11,2,-2,5,0
12,2,-3,8,0
13,1,-3,0,0
14,3,-3,0,0
15,2,-4,0,0
16,-1,0,0,0
17,-2,0,0,0
18,3,-2,0,0
19,4,-2,0,0
20,5,-2,3,0
21,6,-2,0,0
22,5,-3,4,0
23,5,-4,7,0
24,4,-4,0,0
25,6,-4,0,0
26,5,-5,0,0
27,6,-3,1,0
28,7,-3,2,0
29,6,-5,0,0
30,6,-6,0,0
31,7,-5,0,0
32,7,-6,0,0
33,7,-7,0,0
