rooms,xCoords,yCoords,numMonsters,deadlyScore
 -1,0,0,0,0
0,0,0,0,0
1,-1,0,0,0
2,-1,1,0,0
3,0,-1,4,0
4,1,-1,0,0
5,-1,-1,0,0
6,-2,-1,5,0
7,-3,-1,8,0
8,-3,0,0,0
9,-3,-2,0,0
10,-4,-1,0,0
11,-3,1,3,0
12,-2,1,3,0
13,-4,1,0,0
14,-5,1,0,0
15,-5,0,0,0
16,-4,2,3,0
17,-3,2,8,0
18,-3,3,1,0
19,-4,3,0,0
20,-5,3,0,0
21,-6,3,0,0
