rooms,xCoords,yCoords,numMonsters,miniBoss
 -1,0,0,0,0
0,0,0,0,0
1,-1,0,0,0
2,-1,1,0,0
3,-2,1,0,0
4,-1,2,0,0
5,0,1,2,0
6,-2,2,7,0
7,-3,2,8,0
8,-3,3,0,0
9,-3,1,0,0
10,-4,2,0,0
11,-3,4,0,1
12,-3,5,5,0
13,-2,5,7,0
14,-2,4,0,0
15,-2,6,0,0
16,-1,5,0,0
17,-1,3,3,0
18,-1,4,0,0
19,0,3,0,0
20,1,3,0,1
21,1,4,0,0
22,2,3,3,0
23,3,3,7,0
24,3,4,3,0
25,2,4,8,0
26,2,5,5,0
27,3,5,0,0
28,1,5,0,0
29,2,6,0,0
30,4,5,0,0
31,4,6,3,0
32,1,2,0,0
33,1,1,0,1
34,2,2,0,0
35,3,2,0,0
36,4,2,0,0
