rooms,xCoords,yCoords,numMonsters,miniBoss
 -1,0,0,0,0
0,0,0,0,0
1,0,1,0,0
2,-1,1,1,0
3,0,2,1,0
4,0,3,1,0
5,0,4,5,0
6,-1,4,0,1
7,-1,0,0,0
8,-2,0,0,0
9,-3,0,0,0
10,-3,1,0,0
11,-3,2,6,0
12,-3,3,0,0
13,-2,2,0,1
14,-2,1,0,0
15,-4,2,0,0
16,-5,2,6,0
17,-5,3,7,0
18,-4,3,0,0
19,-6,3,0,0
20,-5,4,0,0
21,-4,4,1,0
22,-3,4,1,0
23,-6,4,0,0
24,-7,4,0,1
25,-7,3,0,0
26,-6,5,2,0
27,-5,5,5,0
28,-5,6,2,0
29,-6,6,0,0
30,-6,7,0,0
31,-6,8,0,0
