rooms,xCoords,yCoords,numMonsters,miniBoss
 -1,0,0,0,0
0,0,0,0,0
1,-1,0,3,0
2,-2,0,0,0
3,-2,1,5,0
4,-2,2,0,0
5,-3,1,0,1
6,-3,0,0,0
7,-1,-1,0,0
8,0,-1,6,0
9,0,-2,0,0
10,-2,-1,2,0
11,-2,-2,2,0
12,-1,-2,0,0
13,-1,-3,0,1
14,-1,-4,0,0
15,-2,-3,0,0
16,-2,-4,1,0
17,-3,-3,4,0
18,-4,-3,6,0
19,-4,-2,0,0
20,-4,-4,0,0
21,-5,-3,0,0
22,0,-3,0,1
23,1,-3,0,0
24,-5,-4,0,0
25,-6,-4,1,0
26,-6,-3,0,0
27,-5,-5,1,0
28,-4,-5,2,0
29,-6,-5,6,0
30,-6,-2,0,1
31,-7,-4,0,0
32,-8,-4,0,0
33,-8,-3,0,0
34,-9,-3,0,0
