rooms,xCoords,yCoords,numMonsters,miniBoss
 -1,0,0,0,0
0,0,0,0,0
1,0,-1,5,0
2,-1,-1,0,0
3,-2,-1,0,0
4,-2,-2,3,0
5,-1,0,0,0
6,-2,0,0,1
7,-3,0,0,0
8,-4,0,3,0
9,-5,0,0,0
10,-5,1,7,0
11,-5,2,0,1
12,-6,2,0,0
13,-4,2,0,0
14,-4,1,0,0
15,-3,1,3,0
16,-3,2,6,0
17,-2,2,0,0
18,-4,3,0,1
19,-5,3,0,0
20,-5,4,2,0
21,-5,5,8,0
22,-6,5,2,0
23,-4,5,0,0
24,-3,5,0,0
25,-3,6,0,0
